111111111
101P00001
1C0011011
111010001
10E0000C1
111111111