1111111111111
10010010000C1
1000001111011
1P0010E000001
1111111111111