1111111111111111111111111111111111
1C0000E0000M000C00000C000000000001
111001010010M000101001000M00010101
1010010010101010001001000000010101
1P0000000C00C0000M0000M000000000C1
1111111111111111111111111111111111