1111111111111111111111111111111111
1E0M00M00000M00C00000C0000MM000M01
1010010100100000101001000000010101
1M10010010101010M01001000000010101
1PM000000C00C00M0M00M0000M00M0M0C1
1111111111111111111111111111111111